00000000000000000000
00000000000000000000
00000000000000000000
00000000000000000000
00000000000000000000
00000000000000001001
00000000000000002112
00000000000000003223
00000000000000004334
11000000000000115445
11111111111111116556
77777777777777777667
88888888888888888778
88888888888888888778
22222222222222222222
11111111111111111111
11100000000000000111
10000000000000000001
00000000000000000000
00000000000000000000