76545565544321000001
76556676655432100011
66556787766543210122
55567898877664321232
44566789987776532332
34555678877764321231
23343567766654200122
02001356655543000011
01013466654320000001
00002466542000000000
00013455310000000000
00123443210000011001
00012343210000122101
00001232100000122101
00000121000000011000
00000010010000000000
00001111111010111110
00111222222222222221
01222222333333333332
00012333333444444443