00000000000000000000
00000000000000000000
00000000010000000000
00000000222000000000
00000002333101000000
00000123666320000000
00000236676632100000
00002367777763200000
00003677888776320000
00236778898877632000
01236778999877632100
00236778898877632000
00023677888776320000
00002367777763200000
00000236676632000000
00000123666322000000
00000002333200100000
00000000222000000000
00000000010000000000
00000000000000000000